32
53 27 91 72 86 68 62 69 47 67 50 77 100 10 15 39 92 95 97 26 49 11 29 95 31 46 58 75 75 96 18 85
50 60 74 93 43 54 69 10 91 63 17 51 48 78 44 14 90 73 80 37 43 39 80 84 28 67 81 29 61 44 47 48
78 98 23 12 99 57 12 47 40 56 20 51 36 59 11 74 36 45 17 19 99 51 23 24 86 30 89 55 64 73 28 10
57 30 39 42 61 42 82 14 24 59 24 10 19 36 41 67 67 50 92 19 37 49 84 63 76 43 77 38 60 50 63 61
60 12 54 64 12 98 81 88 70 87 43 82 63 85 62 70 77 17 24 49 70 64 54 78 40 21 34 41 45 22 51 53
57 94 10 22 24 37 87 54 89 90 35 79 30 64 79 36 52 36 47 67 69 12 68 27 57 32 10 19 44 88 63 13
14 97 83 68 38 10 45 96 15 84 56 97 20 49 44 96 82 93 80 41 42 98 85 35 79 11 80 35 45 61 59 69
67 74 51 48 77 35 12 94 89 84 42 72 38 10 78 71 79 55 32 26 70 90 43 76 25 62 73 12 32 37 24 52
92 74 88 17 56 76 64 24 68 97 67 95 54 48 72 35 96 89 60 31 41 28 34 28 67 50 22 12 60 60 94 46
30 92 34 80 32 63 80 16 10 10 43 65 43 19 74 39 50 60 48 30 53 28 73 63 70 99 16 38 82 14 60 33
77 56 72 86 10 11 59 54 46 61 77 91 72 40 18 92 73 57 63 32 18 60 63 22 26 19 82 67 19 29 29 46
67 44 39 43 97 98 42 84 80 78 77 31 78 52 100 47 17 39 25 51 74 58 68 100 100 57 44 51 51 53 27 43
62 51 87 37 97 66 14 63 23 63 78 77 10 65 65 43 47 24 31 95 64 55 69 89 24 92 10 30 44 38 45 85
93 54 48 69 82 49 86 11 41 19 77 63 79 37 75 92 73 82 37 49 44 51 96 74 99 88 87 74 22 80 91 92
57 34 56 41 84 40 53 41 19 17 90 44 86 50 48 76 45 84 68 37 25 74 11 46 95 45 92 63 35 62 49 37
36 70 58 55 42 64 79 59 82 72 35 33 54 38 56 24 73 60 24 99 13 19 78 48 77 39 80 27 48 21 100 99
69 80 23 25 27 64 53 33 58 47 17 51 49 54 14 39 24 21 86 35 37 65 87 65 40 19 71 25 47 56 14 41
31 42 44 23 50 65 31 24 72 11 73 58 91 100 91 27 30 45 95 23 80 59 35 86 64 85 92 80 22 32 56 87
23 15 96 92 13 64 81 15 58 72 70 65 53 85 67 21 28 47 90 70 64 59 54 18 35 69 61 40 24 32 82 38
98 62 95 64 75 71 78 96 80 12 57 71 83 47 85 74 30 57 21 85 24 92 64 82 21 72 13 21 33 23 71 69
34 100 75 73 29 16 50 99 72 53 14 45 70 94 98 85 15 62 13 90 44 11 31 43 54 42 92 52 89 85 24 86
24 46 35 93 30 58 92 55 65 43 11 65 20 58 12 48 26 27 11 12 93 94 83 68 78 24 75 93 60 76 82 73
63 52 33 59 18 11 12 65 52 97 68 47 37 36 73 44 71 46 45 79 72 91 76 25 49 34 80 73 51 74 71 80
37 84 65 59 63 66 80 26 65 28 97 49 95 27 58 98 24 37 65 55 22 47 75 55 34 80 20 23 72 78 53 64
80 81 51 46 37 53 98 79 60 66 18 52 65 90 68 13 28 76 52 47 94 85 49 33 44 27 42 32 61 35 54 73
11 35 55 56 96 29 69 91 58 17 29 59 26 23 67 69 50 31 27 18 10 58 88 25 77 59 45 53 49 98 28 51
51 19 37 90 53 88 37 59 74 58 62 33 34 69 76 23 87 85 82 42 20 91 33 70 15 97 96 78 63 69 13 87
39 10 30 57 90 91 43 38 28 94 99 64 21 67 30 74 27 96 41 57 58 50 24 80 80 57 31 40 23 72 52 16
98 50 49 24 83 28 82 98 93 36 91 23 48 25 73 91 71 13 80 55 67 33 23 70 36 33 57 79 39 86 36 33
53 46 36 20 44 34 18 68 90 100 63 65 54 50 60 46 13 25 89 82 28 45 45 95 75 88 83 86 14 18 47 35
81 29 52 14 52 40 49 95 66 52 19 69 76 90 75 31 24 64 82 50 89 65 96 39 33 52 41 69 10 96 33 56
37 40 49 79 24 31 100 49 33 97 100 74 11 67 32 20 89 73 94 16 86 90 23 80 33 86 21 37 97 81 85 28
